C4
000000000
0       0
0-------0
0|     |0
0--   --0
0       0
000000000




Possible moves:
down